C 33, 147, 235
F 115, 115, 115

WE texture/eagle.xpm
NO texture/greystone.xpm
EA texture/purplestone.xpm
SO texture/red.xpm

1111111111111111111111
1000000000110000000001
1000000000110000000001
1000000000110000000001
1000000000110000000001
1011100000110111000001
1000000000000000000001
1000000000000000000001111111111
1000000000000000000000000000001
1000000000110000000001111111111
1000000000000000000001
1000000000110000000001
1000000000110000000001
1000000000110000000S01
1000000000110000000001
1000000000110000000001
1011100000110111000001
1000000000000000000001
1000000000000000000001
1000000000000000000001
1000000000000000000001
1000000000000000000001
1000000000000000000001
1000000000000000000001
1000000000000000000001
1000000000000000000001
1000000000000000000001
1111111111111111111111
