C 33, 147, 235
F 115, 115    , 115

WE texture/eagle.xpm
NO texture/greystone.xpm
EA texture/purplestone.xpm
SO texture/red.xpm

	1111111111111111111111
	1000000000110000000001
	111111000000110000001111
     10000000011000000001
     10000000011000001111
1111110000110111000001
1000000000000000000001
1000000000000000000001111111111
1000000000000000000000000000001
1000000000110000000001111111111
1000000000000000000001
1000000000110000000001
100000N000110000000001
1000000000110000000001
1000000000110000000001
1000000000110000000001
1111101111111111111111
	1011
    1011
	1001
	1111