	   11111111111111111111111111 
	   10000000000110000000000001
	   10011000001110000000000001
	   10001000000000000000000001
111111110001000001110000000000001
100000000001000001110111110000111
1111011101011101110000001000001
1111011101011101110101001000001
1100000001010101110000001000111
10000000000000001100000010001
10000000000000001101010010001
1100001110101011111011110N0111
1100001 1110101 101111010001
1111111 1111111 111111111111