11111111111
10000000001
10000000P01
10000000001
10000000001
10111000001
10000000001
10000000001
10000000001
10000000001
11111111111
