1111111111111111111111
1000000000110000000001
1000000000110000000001
1111110000111111100001
1000000000110000000001
1000000000110000000001
1000000000110000000001
1000000000110000000001
1000010000110000100001
10000000P0011000000001
1111111111111111111111
1000000000110000000001
1000000000110000000001
1111110000111111100001
1000000000110000000001
1000000000110000000001
1000000000110000000001
1000000000110000000001
1000010000110000100001
1000000000110000000001
1111111111111111111111