1111111111111111111111
1000000000110000000001
1000000000110000000001
1000000000110000000001
1000000000110000000001
1011100000110111000001
1000000000000000000001
1000000000000000000001
1000000000000000000001
1000000000110000000001
1000000000000000000001
1000000000000000000001
1000000000110000000001
1000000000110000000P01
1000000000110000000001
1000000000110000000001
1011100000110111000001
1000000000110000000001
1000000000110000000001
1000000000110000000001
1000000000110000000001
1111111111111111111111
